F 139,99,58
C 171,154,137

NO sprites/simonkraft/bookshelf.xpm
SO sprites/simonkraft/bookshelf_01.xpm
WE sprites/simonkraft/bookshelf_02.xpm
EA sprites/simonkraft/bookshelf_03.xpm

111111111111111111111111111111111111111111111111111111111111111111111111111111111111111111111111111111111111111111111111111111111111111111111111111111
100100100100100100001001001001001000010010010010010000100100100100100001001001001001000010010010010010000100100100100100001001001001001000010010000001
100100100100100100001001001001001000010010010010010000100100100100100001001001001001000010010010010010000100100100100100001001001001001000010010000001
100100100100100100001001001001001000010010010010010000100100100100100001001001001001000010010010010010000100100100100100001001001001001000010010000001
100100100000100100001001000001001000010010000010010000100100000100100001001000001001000010010000010010000100100000100100001001000001001000010010000001
100000000000000000000000000000000000000000000000000000000000S00000000000000000000000000000000000000000000000000000000000000000000000000000000000000001
100001111111100000000011111111000000000111111110000000001111111100000000011111111000000000111111110000000001111111100000000011111111000000000111000001
111100000000000111111000000000001111110000000000011111100000000000111111000000000001111110000000000011111100000000000111111000000000001111110000000001
100000010101000000000000101010000000000001010100000000000010101000000000000101010000000000001010100000000000010101000000000000101010000000000001000001
100100100100100100001001001001001000010010010010010000100100100100100001001001001001000010010010010010000100100100100100001001001001001000010010000001
100100100100100100001001001001001000010010010010010000100100100100100001001001001001000010010010010010000100100100100100001001001001001000010010000001
100100100100100100001001001001001000010010010010010000100100100100100001001001001001000010010010010010000100100100100100001001001001001000010010000001
100100100000100100001001000001001000010010000010010000100100000100100001001000001001000010010000010010000100100000100100001001000001001000010010000001
100000000000000000000000000000000000000000000000000000000000000000000000000000000000000000000000000000000000000000000000000000000000000000000000000001
100001111111100000000011111111000000000111111110000000001111111100000000011111111000000000111111110000000001111111100000000011111111000000000111000001
111100000000000111111000000000001111110000000000011111100000000000111111000000000001111110000000000011111100000000000111111000000000001111110000000001
100000010101000000000000101010000000000001010100000000000010101000000000000101010000000000001010100000000000010101000000000000101010000000000001000001
100100100100100100001001001001001000010010010010010000100100100100100001001001001001000010010010010010000100100100100100001001001001001000010010000001
100100100100100100001001001001001000010010010010010000100100100100100001001001001001000010010010010010000100100100100100001001001001001000010010000001
100100100100100100001001001001001000010010010010010000100100100100100001001001001001000010010010010010000100100100100100001001001001001000010010000001
100100100000100100001001000001001000010010000010010000100100000100100001001000001001000010010000010010000100100000100100001001000001001000010010000001
100000000000000000000000000000000000000000000000000000000000000000000000000000000000000000000000000000000000000000000000000000000000000000000000000001
100001111111100000000011111111000000000111111110000000001111111100000000011111111000000000111111110000000001111111100000000011111111000000000111000001
111100000000000111111000000000001111110000000000011111100000000000111111000000000001111110000000000011111100000000000111111000000000001111110000000001
100000010101000000000000101010000000000001010100000000000010101000000000000101010000000000001010100000000000010101000000000000101010000000000001000001
100100100100100100001001001001001000010010010010010000100100100100100001001001001001000010010010010010000100100100100100001001001001001000010010000001
100100100100100100001001001001001000010010010010010000100100100100100001001001001001000010010010010010000100100100100100001001001001001000010010000001
100100100100100100001001001001001000010010010010010000100100100100100001001001001001000010010010010010000100100100100100001001001001001000010010000001
100100100000100100001001000001001000010010000010010000100100000100100001001000001001000010010000010010000100100000100100001001000001001000010010000001
100000000000000000000000000000000000000000000000000000000000000000000000000000000000000000000000000000000000000000000000000000000000000000000000000001
100001111111100000000011111111000000000111111110000000001111111100000000011111111000000000111111110000000001111111100000000011111111000000000111000001
111100000000000111111000000000001111110000000000011111100000000000111111000000000001111110000000000011111100000000000111111000000000001111110000000001
100000010101000000000000101010000000000001010100000000000010101000000000000101010000000000001010100000000000010101000000000000101010000000000001000001
100100100100100100001001001001001000010010010010010000100100100100100001001001001001000010010010010010000100100100100100001001001001001000010010000001
100100100100100100001001001001001000010010010010010000100100100100100001001001001001000010010010010010000100100100100100001001001001001000010010000001
100100100100100100001001001001001000010010010010010000100100100100100001001001001001000010010010010010000100100100100100001001001001001000010010000001
100100100000100100001001000001001000010010000010010000100100000100100001001000001001000010010000010010000100100000100100001001000001001000010010000001
100000000000000000000000000000000000000000000000000000000000000000000000000000000000000000000000000000000000000000000000000000000000000000000000000001
100001111111100000000011111111000000000111111110000000001111111100000000011111111000000000111111110000000001111111100000000011111111000000000111000001
111100000000000111111000000000001111110000000000011111100000000000111111000000000001111110000000000011111100000000000111111000000000001111110000000001
100000010101000000000000101010000000000001010100000000000010101000000000000101010000000000001010100000000000010101000000000000101010000000000001000001
100100100100100100001001001001001000010010010010010000100100100100100001001001001001000010010010010010000100100100100100001001001001001000010010000001
100100100100100100001001001001001000010010010010010000100100100100100001001001001001000010010010010010000100100100100100001001001001001000010010000001
100100100100100100001001001001001000010010010010010000100100100100100001001001001001000010010010010010000100100100100100001001001001001000010010000001
100100100000100100001001000001001000010010000010010000100100000100100001001000001001000010010000010010000100100000100100001001000001001000010010000001
100000000000000000000000000000000000000000000000000000000000000000000000000000000000000000000000000000000000000000000000000000000000000000000000000001
100001111111100000000011111111000000000111111110000000001111111100000000011111111000000000111111110000000001111111100000000011111111000000000111000001
111100000000000111111000000000001111110000000000011111100000000000111111000000000001111110000000000011111100000000000111111000000000001111110000000001
100000010101000000000000101010000000000001010100000000000010101000000000000101010000000000001010100000000000010101000000000000101010000000000001000001
100100100100100100001001001001001000010010010010010000100100100100100001001001001001000010010010010010000100100100100100001001001001001000010010000001
100100100100100100001001001001001000010010010010010000100100100100100001001001001001000010010010010010000100100100100100001001001001001000010010000001
100100100100100100001001001001001000010010010010010000100100100100100001001001001001000010010010010010000100100100100100001001001001001000010010000001
100100100000100100001001000001001000010010000010010000100100000100100001001000001001000010010000010010000100100000100100001001000001001000010010000001
100000000000000000000000000000000000000000000000000000000000000000000000000000000000000000000000000000000000000000000000000000000000000000000000000001
100001111111100000000011111111000000000111111110000000001111111100000000011111111000000000111111110000000001111111100000000011111111000000000111000001
111100000000000111111000000000001111110000000000011111100000000000111111000000000001111110000000000011111100000000000111111000000000001111110000000001
100000010101000000000000101010000000000001010100000000000010101000000000000101010000000000001010100000000000010101000000000000101010000000000001000001
100100100100100100001001001001001000010010010010010000100100100100100001001001001001000010010010010010000100100100100100001001001001001000010010000001
100100100100100100001001001001001000010010010010010000100100100100100001001001001001000010010010010010000100100100100100001001001001001000010010000001
100100100100100100001001001001001000010010010010010000100100100100100001001001001001000010010010010010000100100100100100001001001001001000010010000001
100100100000100100001001000001001000010010000010010000100100000100100001001000001001000010010000010010000100100000100100001001000001001000010010000001
100000000000000000000000000000000000000000000000000000000000000000000000000000000000000000000000000000000000000000000000000000000000000000000000000001
100001111111100000000011111111000000000111111110000000001111111100000000011111111000000000111111110000000001111111100000000011111111000000000111000001
111100000000000111111000000000001111110000000000011111100000000000111111000000000001111110000000000011111100000000000111111000000000001111110000000001
100000010101000000000000101010000000000001010100000000000010101000000000000101010000000000001010100000000000010101000000000000101010000000000001000001
100100100100100100001001001001001000010010010010010000100100100100100001001001001001000010010010010010000100100100100100001001001001001000010010000001
100100100100100100001001001001001000010010010010010000100100100100100001001001001001000010010010010010000100100100100100001001001001001000010010000001
100100100100100100001001001001001000010010010010010000100100100100100001001001001001000010010010010010000100100100100100001001001001001000010010000001
100100100000100100001001000001001000010010000010010000100100000100100001001000001001000010010000010010000100100000100100001001000001001000010010000001
100000000000000000000000000000000000000000000000000000000000000000000000000000000000000000000000000000000000000000000000000000000000000000000000000001
100001111111100000000011111111000000000111111110000000001111111100000000011111111000000000111111110000000001111111100000000011111111000000000111000001
111100000000000111111000000000001111110000000000011111100000000000111111000000000001111110000000000011111100000000000111111000000000001111110000000001
100000010101000000000000101010000000000001010100000000000010101000000000000101010000000000001010100000000000010101000000000000101010000000000001000001
100100100100100100001001001001001000010010010010010000100100100100100001001001001001000010010010010010000100100100100100001001001001001000010010000001
100100100100100100001001001001001000010010010010010000100100100100100001001001001001000010010010010010000100100100100100001001001001001000010010000001
100100100100100100001001001001001000010010010010010000100100100100100001001001001001000010010010010010000100100100100100001001001001001000010010000001
100100100000100100001001000001001000010010000010010000100100000100100001001000001001000010010000010010000100100000100100001001000001001000010010000001
100000000000000000000000000000000000000000000000000000000000000000000000000000000000000000000000000000000000000000000000000000000000000000000000000001
100001111111100000000011111111000000000111111110000000001111111100000000011111111000000000111111110000000001111111100000000011111111000000000111000001
111100000000000111111000000000001111110000000000011111100000000000111111000000000001111110000000000011111100000000000111111000000000001111110000000001
100000010101000000000000101010000000000001010100000000000010101000000000000101010000000000001010100000000000010101000000000000101010000000000001000001
100100100100100100001001001001001000010010010010010000100100100100100001001001001001000010010010010010000100100100100100001001001001001000010010000001
100100100100100100001001001001001000010010010010010000100100100100100001001001001001000010010010010010000100100100100100001001001001001000010010000001
100100100100100100001001001001001000010010010010010000100100100100100001001001001001000010010010010010000100100100100100001001001001001000010010000001
100100100000100100001001000001001000010010000010010000100100000100100001001000001001000010010000010010000100100000100100001001000001001000010010000001
100000000000000000000000000000000000000000000000000000000000000000000000000000000000000000000000000000000000000000000000000000000000000000000000000001
100001111111100000000011111111000000000111111110000000001111111100000000011111111000000000111111110000000001111111100000000011111111000000000111000001
111100000000000111111000000000001111110000000000011111100000000000111111000000000001111110000000000011111100000000000111111000000000001111110000000001
100000010101000000000000101010000000000001010100000000000010101000000000000101010000000000001010100000000000010101000000000000101010000000000001000001
100100100100100100001001001001001000010010010010010000100100100100100001001001001001000010010010010010000100100100100100001001001001001000010010000001
100100100100100100001001001001001000010010010010010000100100100100100001001001001001000010010010010010000100100100100100001001001001001000010010000001
100100100100100100001001001001001000010010010010010000100100100100100001001001001001000010010010010010000100100100100100001001001001001000010010000001
100100100000100100001001000001001000010010000010010000100100000100100001001000001001000010010000010010000100100000100100001001000001001000010010000001
100000000000000000000000000000000000000000000000000000000000000000000000000000000000000000000000000000000000000000000000000000000000000000000000000001
100001111111100000000011111111000000000111111110000000001111111100000000011111111000000000111111110000000001111111100000000011111111000000000111000001
111100000000000111111000000000001111110000000000011111100000000000111111000000000001111110000000000011111100000000000111111000000000001111110000000001
100000010101000000000000101010000000000001010100000000000010101000000000000101010000000000001010100000000000010101000000000000101010000000000001000001
100100100100100100001001001001001000010010010010010000100100100100100001001001001001000010010010010010000100100100100100001001001001001000010010000001
100100100100100100001001001001001000010010010010010000100100100100100001001001001001000010010010010010000100100100100100001001001001001000010010000001
100100100100100100001001001001001000010010010010010000100100100100100001001001001001000010010010010010000100100100100100001001001001001000010010000001
100100100000100100001001000001001000010010000010010000100100000100100001001000001001000010010000010010000100100000100100001001000001001000010010000001
100000000000000000000000000000000000000000000000000000000000000000000000000000000000000000000000000000000000000000000000000000000000000000000000000001
100001111111100000000011111111000000000111111110000000001111111100000000011111111000000000111111110000000001111111100000000011111111000000000111000001
111100000000000111111000000000001111110000000000011111100000000000111111000000000001111110000000000011111100000000000111111000000000001111110000000001
100000010101000000000000101010000000000001010100000000000010101000000000000101010000000000001010100000000000010101000000000000101010000000000001000001
100100100100100100001001001001001000010010010010010000100100100100100001001001001001000010010010010010000100100100100100001001001001001000010010000001
100100100100100100001001001001001000010010010010010000100100100100100001001001001001000010010010010010000100100100100100001001001001001000010010000001
100100100100100100001001001001001000010010010010010000100100100100100001001001001001000010010010010010000100100100100100001001001001001000010010000001
100100100000100100001001000001001000010010000010010000100100000100100001001000001001000010010000010010000100100000100100001001000001001000010010000001
100000000000000000000000000000000000000000000000000000000000000000000000000000000000000000000000000000000000000000000000000000000000000000000000000001
100001111111100000000011111111000000000111111110000000001111111100000000011111111000000000111111110000000001111111100000000011111111000000000111000001
111100000000000111111000000000001111110000000000011111100000000000111111000000000001111110000000000011111100000000000111111000000000001111110000000001
100000010101000000000000101010000000000001010100000000000010101000000000000101010000000000001010100000000000010101000000000000101010000000000001000001
100100100100100100001001001001001000010010010010010000100100100100100001001001001001000010010010010010000100100100100100001001001001001000010010000001
100100100100100100001001001001001000010010010010010000100100100100100001001001001001000010010010010010000100100100100100001001001001001000010010000001
100100100100100100001001001001001000010010010010010000100100100100100001001001001001000010010010010010000100100100100100001001001001001000010010000001
100100100000100100001001000001001000010010000010010000100100000100100001001000001001000010010000010010000100100000100100001001000001001000010010000001
100000000000000000000000000000000000000000000000000000000000000000000000000000000000000000000000000000000000000000000000000000000000000000000000000001
100001111111100000000011111111000000000111111110000000001111111100000000011111111000000000111111110000000001111111100000000011111111000000000111000001
111100000000000111111000000000001111110000000000011111100000000000111111000000000001111110000000000011111100000000000111111000000000001111110000000001
100000010101000000000000101010000000000001010100000000000010101000000000000101010000000000001010100000000000010101000000000000101010000000000001000001
100100100100100100001001001001001000010010010010010000100100100100100001001001001001000010010010010010000100100100100100001001001001001000010010000001
100100100100100100001001001001001000010010010010010000100100100100100001001001001001000010010010010010000100100100100100001001001001001000010010000001
100100100100100100001001001001001000010010010010010000100100100100100001001001001001000010010010010010000100100100100100001001001001001000010010000001
100100100000100100001001000001001000010010000010010000100100000100100001001000001001000010010000010010000100100000100100001001000001001000010010000001
100000000000000000000000000000000000000000000000000000000000000000000000000000000000000000000000000000000000000000000000000000000000000000000000000001
100001111111100000000011111111000000000111111110000000001111111100000000011111111000000000111111110000000001111111100000000011111111000000000111000001
111100000000000111111000000000001111110000000000011111100000000000111111000000000001111110000000000011111100000000000111111000000000001111110000000001
100000010101000000000000101010000000000001010100000000000010101000000000000101010000000000001010100000000000010101000000000000101010000000000001000001
100100100100100100001001001001001000010010010010010000100100100100100001001001001001000010010010010010000100100100100100001001001001001000010010000001
100100100100100100001001001001001000010010010010010000100100100100100001001001001001000010010010010010000100100100100100001001001001001000010010000001
100100100100100100001001001001001000010010010010010000100100100100100001001001001001000010010010010010000100100100100100001001001001001000010010000001
100100100000100100001001000001001000010010000010010000100100000100100001001000001001000010010000010010000100100000100100001001000001001000010010000001
100000000000000000000000000000000000000000000000000000000000000000000000000000000000000000000000000000000000000000000000000000000000000000000000000001
100001111111100000000011111111000000000111111110000000001111111100000000011111111000000000111111110000000001111111100000000011111111000000000111000001
111100000000000111111000000000001111110000000000011111100000000000111111000000000001111110000000000011111100000000000111111000000000001111110000000001
100000010101000000000000101010000000000001010100000000000010101000000000000101010000000000001010100000000000010101000000000000101010000000000001000001
100100100100100100001001001001001000010010010010010000100100100100100001001001001001000010010010010010000100100100100100001001001001001000010010000001
100100100100100100001001001001001000010010010010010000100100100100100001001001001001000010010010010010000100100100100100001001001001001000010010000001
100100100100100100001001001001001000010010010010010000100100100100100001001001001001000010010010010010000100100100100100001001001001001000010010000001
100100100000100100001001000001001000010010000010010000100100000100100001001000001001000010010000010010000100100000100100001001000001001000010010000001
100000000000000000000000000000000000000000000000000000000000000000000000000000000000000000000000000000000000000000000000000000000000000000000000000001
100001111111100000000011111111000000000111111110000000001111111100000000011111111000000000111111110000000001111111100000000011111111000000000111000001
111100000000000111111000000000001111110000000000011111100000000000111111000000000001111110000000000011111100000000000111111000000000001111110000000001
100000010101000000000000101010000000000001010100000000000010101000000000000101010000000000001010100000000000010101000000000000101010000000000001000001
100100100100100100001001001001001000010010010010010000100100100100100001001001001001000010010010010010000100100100100100001001001001001000010010000001
100100100100100100001001001001001000010010010010010000100100100100100001001001001001000010010010010010000100100100100100001001001001001000010010000001
100100100100100100001001001001001000010010010010010000100100100100100001001001001001000010010010010010000100100100100100001001001001001000010010000001
100100100100100100001001001001001000010010010010010000100100100100100001001001001001000010010010010010000100100100100100001001001001001000010010000001
111111111111111111111111111111111111111111111111111111111111111111111111111111111111111111111111111111111111111111111111111111111111111111111111111111
