NO sprites/wolfenstein/grey_stone.xpm
SO sprites/wolfenstein/purple_stone.xpm
WE sprites/wolfenstein/red_brick.xpm
EA sprites/wolfenstein/wood.xpm

F 18,53,25
C 153,204,255

111111111111
1         11
1          1
111111111111
10S000000001
110111101111
110000101  1
111111111111
