NO sprites/wolfenstein/grey_stone.xpm
SO sprites/wolfenstein/purple_stone.xpm
WE sprites/wolfenstein/red_brick.xpm
EA sprites/wolfenstein/wood.xpm

F 96,108,56
C 173,232,244

        1111111111111111111111111
        1000000000110000000000001
        1011000001110000000000001
        1001000000000000000000001
111111111011000001110000000000001
100000000011000001110111111111111
11110111111111011100000010001
111101111 1111011101010000001
11000000110101011100000010001
10000000000000001100000010001
10000000000000001101010010001
11000001110101011111011110N0111
11110111 1110101 101111010001
11111111 1111111 111111111111
