NO sprites/wolfenstein/grey_stone.xpm
SO sprites/wolfenstein/purple_stone.xpm
WE sprites/wolfenstein/red_brick.xpm
EA sprites/wolfenstein/wood.xpm

F 18,53,25
C 153,204,255

1          1
1          1
1          1
111111111111
111111111111
10S000000001
111111111111
110000000001
111111111111


