NO sprites/test/north.xpm
SO sprites/test/south.xpm
WE sprites/test/west.xpm
EA sprites/test/east.xpm

F 20,20,20
C 200,200,200


1111111111111
111100011111
11110S01111111111111111111111111111111111111111111111111111111111111111111111111111
11110001111 
1111111111111
1
1
1
1
1
1
11
1
11
11
1
1
1
1
1
1
1
1
1
1
N