NO sprites/test/north.xpm
SO sprites/test/south.xpm
WE sprites/test/west.xpm
EA sprites/test/east.xpm

F 20,20,20
C 200,200,200


                               11111111111111111111111111111111111111111
                               11100000000000000000000000000000000011111
111111111111111111111111111111111110111111111111111111111111111111S11111
11100000000000000000000000000000000011111                         
111111111111111111111111111111111110111111111111111111111111111111111111
                               11100000000000000000000000000000000011111
                               11111111111111111111111111111111111111111