NO sprites/test/north.xpm
SO sprites/test/south.xpm
WE sprites/test/west.xpm
EA sprites/test/east.xpm

F 20,20,20
C 200,200,200

11111
10001
10S01
10001
10001
10011
101 1
10011
10001
10001
10001
10001
11111
